{
    "name":"Level 9!",
    "map":[
        ["o", "o", "o", "o","o", "o", "o", "o","o", "f"],
        ["o", "x", "x", "x","x", "x", "o", "x","x", "o"],
        ["o", "x", "x", "x","x", "x", "o", "x","x", "o"],
        ["o", "x", "x", "x","x", "x", "o", "x","x", "o"],
        ["o", "o", "o", "o","p", "o", "o", "o","o", "o"],
        ["o", "x", "x", "x","o", "x", "x", "x","x", "o"],
        ["o", "x", "o", "o","o", "x", "x", "x","x", "o"],
        ["o", "x", "o", "x","o", "x", "x", "x","x", "o"],
        ["g", "o", "o", "o","o", "o", "o", "o","o", "o"]
    ],
    "commands":[
        "step",
        "turn",
        "loop",
        "loop4"
    ],
    "orientacao":0
}