{
    "name":"level1",
    "map":[
        ["o", "p", "o", "o", "o", "o", "o", "o" ],
        ["o", "o", "o", "o", "o", "o", "o", "o" ],
        ["o", "o", "o", "o", "o", "o", "o", "o" ],
        ["o", "o", "o", "o", "o", "o", "o", "o" ],
        ["o", "o", "o", "o", "x", "x", "o", "o" ],
        ["o", "o", "o", "o", "o", "x", "o", "o" ],
        ["o", "o", "o", "o", "o", "x", "o", "o" ],
        ["o", "o", "o", "o", "o", "o", "o", "x" ],
        ["o", "o", "o", "o", "o", "o", "o", "f" ]
    ],
    "commands":[
        "step",
        "turn",
        "loop2"
    ]
}